1111111111111
1000000000001
1000000000111
10000N0000001
1000000000111
1000010100001
111111 111111
111111 111111