1111111111111
1000000000001
1000000000001
1000000000001
100000N000001
111111 111111