NO ./img/north.xpm
SO ./img/okau.xpm
WE ./img/debug.xpm
EA ./img/tnt.xpm

F 220,100,0
C 225,30,0

1111111111111
1000000N00001
1000000000001
1111111111111

1111111111111
1000000000001
1000000000001
1111111111111