

F 220,100,0
C 225,30,0

1111111111111
1000000000001
1000000000111
10000S0000001
1000000000111
1000011100001
111111 111111
111111 111111
