NO ./img/north.xpm
SO ./img/okau.xpm
WE ./img/debug.xpm
EA ./img/tnt.xpm

1111111111111
1W00000000001
1000000000001
1000000000001
1000000000001
1111111111111