    1111111111111
1111000000001
100000N000001
1000000000001
1000000000001
1111111111111