1111111111111
1000000000001
1000N00000001
1000000S00001
1000000000001
1111111111111