      C 0, 0, 256
F 255, 255, 0

NO ./img/north.xpm
SO ./img/okau.xpm
WE ./img/debug.xpm
EA ./img/tnt.xpm

   111111111111
  1000000000001
  100000N00001
1100000000001
  100000000001
 10000010010001
  11111 11 1111