NO ./img/north.xpm
SO ./img/okau.xpm
WE ./img/debug.xpm
EA ./img/tnt.xpm

F 220,100,0
C 225,30,0

1111111111111111111111111
1000000000110000000000001
1011000001110000000000001
1001000000000E00000000001
1111110000110000011100001
1000000111110001111101111
11110111 1110101 101111010001
11111111 1111111 111111111111